Story=História
fps=FPS\n
Go to Station Square=Vá para a Estação Central\n
Wonder EXP Credit=Crédito de EXP do Wonder
Metaverse=Metaverso
Participants=Participantes
City Life=Vida de Cidade
Persona=Persona
Train/Enhance=Treinar/Aprimorar
Battle=Batalha
Synergy=Sinergia
Quit Navigation=Pare de Navegar
Track=Acompanhar
No missions available.=Sem missões disponíveis.
Nothing here yet.=Nada aqui ainda.
All=Todos
Resist!=Resistir!
Personal Data=Dados Pessoais
Upload Log=Carregar Registro
Delete Account=Excluir Conta
End Game=Finalizar Jogo
Log Out=Sair da Conta
Account=Conta
Support=Suporte
Specified Commercial Transactions Act and Payment Services Act=Lei de Transações Comerciais Especificada e Lei de Serviços de Pagamento
Community=Comunidade
Notices=Avisos
Level of Detail=Nível de Detalhes
Texture Quality=Qualidade de Textura
Effects Quality=Qualidade de Efeitos
Shadow Quality=Qualidade de Sombra
Render Quality=Qualidade de Renderização
Frame Rate=Taxa de Quadros
Dynamic Resolution=Resolução Dinâmica
Screen Resolution=Resolução da Tela
Display-1=Display-1
Display=Exibição
Full Screen=Tela Cheia
Window Mode=Modo Janela
Get=Pegar
SKILL=HABILIDADE
Environment=Ambiente
Voice=Voz
Sound Effects=Efeitos Sonoros
BGM=MF
Volume Settings=Configurações de Volume
Master Volume=Volume Mestre
No friend requests.=Sem pedidos de amizade.
Jump Up=Pular
Jump Down=Descer
Thief Compendium Volume=Volume de Compêndio de Ladrão
Anecdote Cube=Cubo de Anedota
Dark Whisper=Sussurro Sombrio
<color\=#FF423F>Change</color> your battle commands.=<color\=#FF423F>Mude</color> seus comandos de batalha.
Select <color\=#FF423F>Item</color>.=Selecione <color\=#FF423F>Item</color>.
First-Aid Medicine=Primeiros Socorros
Left: 10/10=Restam: 10/10
Restores 150 {{A}} to 1 ally.=Restaura 150 {{A}} de 1 aliado.
Charge=Carga
<color\=#FF423F>Guard</color> to greatly decrease damage taken.=<color\=#FF423F>Guarda</color> diminui bastante o dano recebido.
Select this <color\=#FF423F>skill</color>.=Selecione esta <color\=#FF423F>habilidade</color>.
Bullet Time=Hora da Bala
Seize the Day=Aproveite o Dia
Gun dmg to 1 foe. Inflict Marked on foe.=Dano de Arma em 1 inimigo.\nCausa Marca no inimigo.
Single-Target=Alvo Único
Tatra Shot=Disparo Tatra
Owl Fire=Fogo da Coruja
Activate a <color\=#FF423F>1 More</color>.=Ative <color\=#FF423F>Mais 1 </color>.
When all foes are knocked down,\nyou can unleash an <color\=#FF423F>All-Out Attack</color>\nto deal heavy damage to all targets.=Quando todos os inimigos são derrubados,\nvocê pode liberar um <color\=#FF423F>Ataque Total</color> e causar\ndanos pesados ​​a todos os alvos.
Return to Shibuya=Retorne a Shibuya
Station Square=Praça da Estação
Wingbeat Coin=Moeda Asa Avoada
Obtainable from Daily Hoot-n-Loot. Can be exchanged for rewards in the shop.=Obtido do Hoot-N-Leot Diário.\nPode ser trocado por recompensas na loja.
Currency=Moeda
Konpaku Gem=Gema Konpaku
Whiff of Iris=Aroma de íris
Blue Crystal=Cristal Azul
Skill Incense S=Incenso de Habilidade S
All-Out {{A}}s=Ataques Totais
Take the train to Zoshigaya=Pegue o trem para Zoshigaya
Take the train to Zoshigaya=Pegue o trem para Zoshigaya
Station=Estação
Exchange=Trocar
Notifications=Notificações
Shopping=Compras
In this gacha, the 4★ {{A}} Kotone Montagne is guaranteed.=Neste gacha, a Ladra-Fantasma 4★ Kotone Montagne é garantida.
Left: 50/50=Restam: 50/50
Newcomer {{A}}={{A}} de Novatos
Bicorn=Bicórnio
G<color\=#ff0000ff>o</color> to your bedroom=I<color\=#ff0000ff>r</color> para o seu quarto
Bedroom=Quarto
S<color\=#ff0000ff>l</color>eep=D<color\=#ff0000ff>o</color>rmir
Traces of Dreams=Traços de Sonhos
Switched to Gamepad Mode.=Mudou para o modo Gamepad.
Thief Compendium Tome=Tomo de Compêndio do Ladrão
Learn to craft more infiltration items.=Aprenda a criar mais itens de infiltração.
<size\=56><sprite\=105 tint\=1></size> View <color\=#FF423F>rewards</color>.=<size\=56><sprite\=105 tint\=1></size> Visualizar <color\=#FF423F>recompensas</color>.
CV:=VA:
Living Room=Sala de Estar
Owl Green=Coruja Verde
Healing Satellite=Satélite de Cura
You can sign contracts to recruit more {{A}}s=Você pode assinar contratos para recrutar mais {{A}}s
The Road to Stardom=O Caminho Para o Estrelato
Ice Princess=Princesa de Gelo
Main Stadium Entrance=Entrada Principal do Estádio
Go to the main gate of the Baseball Stadium=Vá ao portão principal do Estádio de Beisebol
Find a way in=Encontre uma forma de entrar
Go to the Secondhand Shop=Vá à Loja de Segunda Mão
S<color\=#FF423F>e</color>condhand Shop=L<color\=#FF423F>o</color>ja de Segunda Mão
You can now craft infiltration tools=Agora você pode criar ferramentas de infiltração
Infiltration Prep=Preparação de Infiltração
Copper Sheet=Folha de Cobre
Try making a hook.=Tente fazer um gancho.
Craft a Grappling Hook=Crie um Gancho de Agarre
Mercury=Mercúrio
Workbench=Bancada de Trabalho
Owl Eyes=Olhos de Coruja
Camel Spin=Giro de Camelo
Let's Hold Hands=Vamos Dar as Mãos
Legend Cube=Cubo da Lenda
Gold Parts=Peças de Ouro
Coffee Aid=Café de Socorro
Clear Cognigem=Cognigema Limpa
Grappling Hook=Gancho de Agarre
Go to bed=Vá para cama
You can insta-kill low-level {{A}}s in {{C}}s or {{B}}=Você pode matar instantâneamente {{A}}s de baixo nível nos {{C}}s ou no {{B}}
3★ Weapon Case=Maleta de Armas 3★\n
Recov-R S=Recupr-Ar S
Violet Cognigem=Cognigema Violeta
Tap screen to close=Toque na tela para fechar
Open the <color\=#FF423F>{{A}}</color>.=Abra o <color\=#FF423F>{{A}}</color>.
Please follow the instructions.=Por favor, siga as instruções
Phantom Pass=Passe-Fantasma
Complete the {{A}} to earn various rewards.=Complete o {{A}} para ganhar diversas recompensas.
Tap screen to close.=Toque na tela para fechar.
Select Goals to view\nthe <color\=#FF423F>Phantom Pass</color> screen.=Selecione Objetivos para ver\na tela do <color\=#FF423F>Passe-Fantasma</color>.\n
Loading...=Carregando...\n
This game is intended for mature audiences.=Este jogo é para audiências maduras.\n
Tap screen to return.=Toque na tela para voltar.\n
A new {{A}} has been unlocked.=Um novo {{A}} foi liberado.\n
Unlock <color\=#FFE500>premium rewards</color>\nand instantly get <color\=#FFE500>650</color> {{A}}!=Desbloqueie <color\=#FFE500>recompensas premium</color>\ne receba instantâneamente <color\=#FFE500>650</color> {{A}}!
Money=Dinheiro
MaraThon Energy=Energia de Montão
Use your Grappling Hook=Use seu Gancho!\n
Use your <color\=#FF423F>Grappling Hook</color>.=Use seu\n<color\=#FF423F>Gancho de Agarre</color>.
Using the Grappling Hook=Usando o Gancho de Agarre\n
Enter the {{A}} interior=Entre no {{A}}.\n
Proceed=Prosseguir\n
The root cause?=A raiz de tudo?\n
An item?=Um item?\n
Protagonist's Level=Nível do Protagonista\n
Stadium of Glory=Estádio da Glória\n
Progress further=Avance\n
Pass Experience Credit=Crédito de Experiência de Passe
Exhibition Hall 1F=Hall de Exposições 1º Andar\n
Open Door=Abrir Porta\n
Try to catch {{A}}s off guard and get\nthe first strike!=Pegue as {{A}}s de surpresa e acerte o primeiro golpe!\n
HIGHLIGHT=DESTAQUE\n
Start by targeting their weak points!=Primeiro, mire nos pontos fracos deles!\n
Daeira=Daeira\n
Surprise Squad=Esquadrão Surpresa\n
Ready for Adventure=Pronta Para a Aventura!\n
Courageous Campaign=Campanha Corajosa
{{B}} to 1 foe. Grant Affection to {{A}} (1 turn).={{B}} em 1 inimigo. Aumenta o Afeto com {{A}} (1 turno).\n
All <color\=#FF423F>attacks</color> have a damage attribute.=Todos <color\=#FF423F>Ataques</color> tem um atributo de dano.\n
When you see <color\=#FF423F>WEAK</color>, you can hit the enemy's weakness.=Quando você vir <color\=#FF423F>FRACO</color>, você achou a fraqueza do inimigo.\n
Treasure Chest=Baú do Tesouro\n
Thief Compendium Scrap=Rascunho do Compêndio de Ladrões\n
Metal Parts=Partes Metálicas\n
Memory Cube=Cubo de Memórias\n
A<color\=#000000>f</color>fection=A<color\=#000000>f</color>eto\n
S<color\=#ff0000ff>a</color>fe Room=S<color\=#ff0000ff>a</color>la Segura\n
Press the mission to show your <color\=#FF423F>current objective on the map</color>.=Pressione na missão para mostrar seu <color\=#FF423F>objetivo atual no mapa</color>.
Crit Rate=Taxa Crítica
Underground Mall=Shopping Subterrânio
Accessway=Acesso
Central Street=Rua Central
M<color\=#ff0000ff>o</color>toha Arai=M<color\=#ff0000ff>o</color>toha Arai
Tutorial Coin=Moeda Tutorial
In this gacha, the 4★ weapon Crime and Punishment is guaranteed.=Nesta gacha, a arma Crime e Punição de 4 ★ é garantida.
Crime and Punishment=Crime e Punição
Shop=Comprar
Press <color\=#FF423F>Draw 1</color>.=Pressione <color\=#FF423F>Puxar 1</color>.
Fatal Knife=Faca Fatal
Weapons=Armas
Enhance and modify your weapons to unleash even greater power.=Aprimore e modifique suas armas para liberar um poder ainda maior.
Open the <color\=#FF423F>phone menu</color>.=Abra o <color\=#FF423F>Menu do Celular</color>.